12:12
3 0 0 0 0 0 0 0 0 0 0 0
21 21 21 0 21 0 21 21 21 21 0 0
0 0 0 0 21 4 21 0 0 21 0 0
0 0 0 0 21 4 21 0 0 21 0 0
0 0 0 0 21 8 21 0 0 21 0 0
0 0 0 0 21 21 21 0 0 21 0 0
0 0 0 0 0 0 0  0 0 21 0 0
0 22 4 22 0 0 0 0 0 21 0 0
0 22 22 22 0 0 0 0 0 21 0 0
0 0 0 0 0 0 0 0 0 21 0 0
4 21 21 21 21 21 21 21 21 21 4 0
10 0 0 0 0 0 0 0 0 0 0 0
