12:12
3 0 0 0 0 0 0 0 0 0 0 0
4 4 4 0 4 0 4 4 4 4 0 0
0 0 0 0 4 4 4 0 0 4 0 0
0 0 0 0 4 4 4 0 0 4 0 0
0 0 0 0 4 8 4 0 0 4 0 0
0 0 0 0 4 4 4 0 0 4 0 0
0 0 0 0 0 0 0 0 0 4 0 0
0 4 4 4 0 0 0 0 0 4 0 0
0 4 4 4 0 0 0 0 0 4 0 0
0 0 0 0 0 0 0 0 0 4 0 0
4 4 4 4 4 4 4 4 4 4 4 0
10 0 0 0 0 11 0 0 0 0 0 0
