12:12
3 0 0 0 0 0 0 0 0 0 0 0
4 4 4 0 4 0 4 4 4 4 0 0
0 0 0 0 4 4 4 0 0 4 0 0
6 0 0 0 4 4 4 0 0 4 0 0
0 0 0 0 4 8 4 0 0 4 0 0
0 0 0 0 4 4 4 0 0 4 0 0
0 0 0 0 0 0 0 0 0 4 0 0
0 22 4 22 0 0 0 0 0 4 0 0
0 22 22 22 0 0 0 0 0 4 0 0
0 0 0 0 0 0 0 0 0 4 0 0
4 4 4 4 4 4 4 4 4 4 4 0
10 0 0 0 0 0 0 0 0 0 0 0
